g,g,g,g,g
a,a,g,g,g
g,g,g,a,g

a,a,a,g,g
a,a,a,g,g
g,g,g,a,g